XXXXXXXXXX
______XXXX
XXXXX_XX_X
XX_____X_X
XX_XXXXX_X
XX_X___X_X
XX_X_XXX_X
___X_X___X
XXXX_X_X_X
XXXXXXXXXX
