XXXXXXXXX_
XXXXXXXXX_
XXXXX_XX__
XX_____X_X
XX_XXXXX_X
XX_X_____X
XXXX_XXXXX
__XX_XXXXX
X____X_X_X
XXXXXXXXXX
