XXXXXX___X
XXXXXXX__X
XXX_XXX__X
XXX_XXXXXX
XXXX_XXXXX
XXXX____XX
XXXXXXX_XX
XXXXXX__XX
XXXXXXXXXX
XX______XX
