XXX___XXXX
XXX_XXXX__
XXX_______
XXXXXXXXX_
__________
_X______XX
__XXXXXXXX
_XXXXXXXXX
_XXXXXXXXX
________XX